Usuario Base,Oponente,unidades desplegadas,unidades sobrevivientes,Unidades Destruidas,"Gano (1 si, 0 no)"
Mord86,Stin94,10,8,2,1
Mord86,Asro25,15,10,5,1
Mord86,Imre78,20,3,17,0
Mord86,Taon95,16,10,6,0
Mord86,Avey48,18,8,10,0
Mord86,Kaez42,20,10,10,0
Mord86,Idin94,30,29,1,1
Mord86,Jado86,25,1,24,0
Stin94,Mord86,21,15,6,0
Stin94,Asro25,19,14,5,0
Stin94,Imre78,18,16,2,1
Stin94,Taon95,10,9,1,0
Stin94,Avey48,19,10,9,1
Stin94,Kaez42,17,8,9,0
Stin94,Idin94,23,3,20,1
Stin94,Jado86,28,5,23,1
